111111111
1000PD001
100000001
100000001
10CC00E01
111111111
