11111111111111111111111111111111
1000000000P000000C000000100CCC01
10000000000000011110000000000001
11111001111110000010000011111001
1000000000C010000011000000001001
100011111000100C000100000111C111
10C010000000000000000000E1111111
11111111111111111111111111111111
